222222222220AA2222233333333333333333333
222222222220112222303333333333333333333
222222222220112223003333333333333333333
222222222000110030003333333333333333333
222222220000110300003333333333333333333
22221111111111111111111111111111111111H
22221111111111111111111111111111111111H
333333333000113333333333333333333333333
333333333000113333333333333333333333333
033333330000113333333333333333333333333
003333300000110033333333333333322223333
000333000000110003333333333333323323333
000030000000110003333333333333323323333
000030000000110003333333333333322223333
000300220000110000333333333333333333333
003002222000110000033333333333333333333
003002222000110000033333333333333333333
003002222000110000033333333333333333333
003002222000110000033333333333333333333
003002222000000000033333333333333333333
003002222000000000033333333333333333333
003002222000000000033333333333333333333



