333333333333332222233333333333333333333
333333333333332222323333333333333333333
333333333333222223223333333333333333333
333333333333222222223333333333333333333
333333333333222222223333333333333333333
33333333333311111111111111111111111111C
33333333333311111111111111111111111111C
333333333000110000033333333333333333333
333333333000110000033333333333333333333
033333330000110000033333333333333223333
003333300000110033333333333333332323333
000333000000110003333333333333323323333
000030000000110003333333333333333323333
000030000000110003333333333333333323333
000300220000110000333333333333333333333
003002222000110000033333333333333333333
003002222000110000033333333333333333333
003002222000110000033333333333333333333
003002222000110000033333333333333333333
003002222000110000033333333333333333333
003002222000110000033333333333333333333
003002222000BB0000033333333333333333333




