333333333333333333333333333333333333333
333333333333333333333333333333333333333
333333333333333333333333333333333333333
333333333333333333333333333333333333333
333333333333333333333333333333333333333
D11111111111111111111111111111111111111
D11111111111111111111111111111111111111
333333333000112222222222222222222222222
333333333000112222222222222222222222222
033333330000112222222222222222222222222
003333300000112222222222222222222222222
000333000000112222222222222222233332222
000030000000112222222222222222222332222
000030000000112222222222222222233332222
000300220000112222222222222322233222222
003002222000112222222222222222233332222
003002222000112222222222222222222222222
003002222000112222222222222222222222222
003002222000112222222222222222222222222
003002222000112222222222222222222222222
003002222000112222222222222222222222222
003002222000EE2222222222222222222222222