00000000ffff44444444
00000001111111144444
00000011111111114444
00000111691111111444
00001111791111111114
00011111111111111114
00111391111691111114
01111111111791111114
41111111111111111114
41111116911139111114
41111117911111111114
41111111111M11111114
41111111111111111114
21111116911116911114
22111117911117911114
22221111111111111114
22222221111111111139
22222222221111113939
22222222222111113939
22222222222239393939