222222222220FF2222233333311333333333333
222222222220112222303333311333333333333
222233332220112223003333311333333344333
022222222000110030003333311333333344333
002222220000110300003333311333333333333
G11111111111111111111111111111111111111
G11111111111111111111111111111111111111
333333333000113333333333311333333333333
333333333000113333333333311333333333333
033333330000113333333333311333333333333
003333300000110033333333311222222222222
000333000000110003333333311222233332222
000030000000110003333333311222222232222
000030000000110222222222211222233332222
000300220000110000333333311322222232222
003002222000113333333333311222233332222
003002222000110000033333311222222222222
003002222000110000033333311333333333333
003002222000110000033333311333333333333
003002222000110000033333311333333333333
003002222000110000033333311333333333333
003002222000110000033333311333333333333
       

